I ############################
    #   #     # #     #     # 
# ### # ##### # # # ### # # # 
# #   #   # #     # #   # #   
# ##### # # ##### # # ### # # 
#   #   # #       # #   # # # 
# ### # ### ##### ########### 
# # # #       #       # # # # 
# # ##### ######### ### # # # 
#         #   # # # #     #   
# # ### ### ### # # # # ### # 
# #   # # # # # #     #   # # 
### ##### # # # # # ##### # ##
# # #     #       # # # # #   
# # # # ### ##### # # # # # # 
#   # # # # # #   # #   # # # 
# ### ### # # # # ### ### ### 
#       #     # #   #   # #   
# ##### # # # # ##### # ### # 
# #     # # # # #     # # # # 
# ### ######### # ####### # # 
# #   # #     #       #   # # 
# # ### ### ##### ### # ##### 
# # #     # # #   #     # #   
##### # # # # ### # # ### # ##
#     # #   #   # # # # # #   
### ##### ##### # # ### # # ##
# # #       #     # # # #   # 
# ### ### ### ### # # # # # # 
#     #         # #       #  F