I ############################
      #   #   #     #   #     
# # # ### # # # # ### ### ### 
# # #   #   #   # #   # #   # 
### ### # ##### ### ### ##### 
#   # # # # # #   #           
# ### # ### # # # ### ########
# #   #   #   # #   #   #   # 
### ### # # ### # ### ### # # 
#   # # # #     #         #   
# ### # ####### ############# 
# # # #   # # #           #   
# # # # ### # ########### ### 
#         #   #   #   #     # 
####### # # # ### ### ### ### 
#     # # # # #       #     # 
##### ### ### # # # # ### ### 
#       #   # # # # # # # #   
####### ### # ##### # # # # ##
# #           #     #   # #   
# # ##### ########### # ### # 
# #   # #   #   #     #   # # 
# ### # # ### # # # # ### # # 
#       # #   # # # # #     # 
# ##### ### # # ### ##### ####
#   #     # # # #     # # #   
# ##### ##### ### ##### # # ##
# # #               # #     # 
# # ####### ##### ### # # ### 
# #           #   #     #    F