I ############################
          #     #       #     
# # ##### # ### ##### ### ### 
# # #         #   #   # # # # 
# # ### ### # ##### ### ### # 
# # #   #   # #   # #       # 
# ######### ### ### # ### ### 
#   #   #       #   #   #     
# ##### # # # ### # ######### 
#   #   # # # # # #           
### ### ### ### # ####### ####
#   # #       #     #         
##### ### # ####### # ### # ##
#         #   # # # # #   #   
# # ### ##### # # # ####### # 
# # #   #       #         # # 
####### ##### # ####### # ####
#           # # # # # # #     
# # ##### ##### # # # # ### ##
# # # # # # # #       #   # # 
# ### # # # # # ### # ##### # 
# #       #     #   #         
### ##### ##### ######### ### 
#       # # #       #     #   
### ### ### ##### ####### # # 
#   #     # #     #   #   # # 
# ##### ### # ####### ####### 
#   # # #       #   #         
### # ####### ##### ### # ### 
#         #           # #   #F